NO ./assets/NO
SO ./assets/SO
WE ./assets/WE
EA ./assets/EA

F 0,0,0
C 190,130,0

        111111111111111111111111111
        101100000111000000000000001
        100100000000000000000000001
11111111101100000111000000000000111
100000000011000001110111111111111
1111011111111101110000001000100111
1111011111111101110101010001011
11000000110101011100000000001
10000000000000001100000010001111
10000000000000001101010010001
1100000111010101111101111000111
10110111 1100101 1011110100N1
11111111 1111111 111111111111
