NO ./assets/NO
SO ./assets/SO
WE ./assets/WE
EA ./assets/EA

F 220,100,0
C 225,30,0

11111111111111111111111111
10000000001100000000000001
10110000011100000000000001
10010000000000000000000001
11111111101100000111000001
10000000001100000111011111
11110111111111011100000011
11110111111111011101010011
11000000110101011100000011
10000000000000001100000011
10000000000000001101010011
11000001110101011111010N01
11110111111010110111000111
11111111111111111111111111